20 20 20 20 20 20 20 20 20 20 20 20 20 20 20 20 20 20 20 20 20 20 20 20 20 2 20 10 20 20 20 20 20 20 20 2 20 20 20 2 20 20 2 20 20 2 20 20 2 20 2 2 20 20 20 20 20 20 20 20
20 20 20 20 20 20 20 20 20 20 20 20 20 20 20 20 20 20 20 20 20 20 20 20 20 2 20 2 2 20 20 20 20 20 20 2 20 20 20 2 20 20 2 20 20 2 2 20 2 20 2 2 20 20 20 20 20 20 20 20
20 20 20 20 20 20 20 20 20 20 20 20 20 20 20 20 20 20 20 20 20 20 20 20 20 2 10 20 20 2 20 20 20 20 20 2 20 2 20 2 20 20 2 20 20 2 20 2 2 20 20 20 20 20 20 20 20 20 20 20
20 20 20 20 20 20 20 20 20 20 20 20 20 20 20 20 20 20 20 20 20 20 20 20 20 2 2 20 20 20 2 2 20 20 20 20 2 2 2 20 20 20 2 20 20 2 20 20 2 20 2 2 20 20 20 20 20 20 20 20
20 20 20 20 20 20 20 20 20 20 20 20 20 20 20 20 20 20 20 20 20 20 20 20 20 2 20 10 20 20 20 2 20 20 20 20 20 20 20 20 20 20 20 20 20 20 20 20 20 20 20 20 20 20 20 20 20 20 20 20
20 20 20 20 20 20 20 20 20 20 20 20 20 20 20 20 20 20 20 20 20 20 20 20 20 2 20 2 20 20 20 20 2 20 20 20 20 20 20 20 20 20 20 20 20 20 20 20 20 20 20 20 20 20 20 20 20 20 20 20
20 20 20 20 20 20 20 20 14 20 20 20 20 20 20 20 20 14 20 20 20 2 2 20 20 2 10 20 20 20 20 20 20 20 20 20 20 20 20 20 20 20 20 20 20 20 20 20 20 20 20 20 20 20 20 20 20 20 20 20
20 20 20 20 20 20 20 20 2 2 2 20 20 20 20 20 20 20 20 20 2 2 20 20 20 2 2 20 20 20 20 20 20 20 20 20 20 20 20 14 20 20 20 20 20 20 20 20 20 20 2 20 20 20 20 20 20 20 20 20
20 20 20 20 20 20 20 2 2 2 2 2 20 20 20 20 20 20 20 2 2 20 20 2 2 20 20 20 20 20 20 20 14 20 2 2 2 2 2 2 2 2 20 20 20 20 20 20 20 20 2 20 20 20 20 20 20 20 20 20
20 20 20 20 20 20 2 2 2 2 2 2 2 20 20 20 20 20 2 2 20 20 2 20 20 20 20 2 20 20 20 20 20 2 20 2 20 20 20 20 20 2 20 20 20 20 20 20 20 20 2 20 20 20 20 20 20 20 20 20
20 20 20 20 20 2 2 2 2 2 2 2 2 2 20 20 20 2 20 20 20 20 20 20 20 20 20 20 20 2 2 2 2 2 20 2 20 20 20 20 20 2 20 20 20 20 20 20 20 20 2 20 20 20 20 20 20 20 20 20
0 2 2 2 2 2 2 2 2 2 2 2 2 2 2 2 2 2 2 2 2 2 2 2 2 2 2 2 2 2 20 20 20 20 20 2 20 20 20 20 20 2 2 2 2 2 2 2 2 2 2 20 20 20 20 20 20 20 20 20
