20 20 20 20 20 20 20 20 20 20 20 20 20 20 20 20 20 20 20 20 20 20 20 20 20 20 20 20 20 20 20 20 20 20 2 2 20 2 2 20 2 20 2 20 2 20 20 2 20 20 20 20 20 20 20 20 20 20 20 20
20 20 20 20 20 20 20 20 20 20 20 20 20 20 20 20 20 20 20 20 20 20 20 20 20 20 20 20 20 20 20 20 20 20 2 2 2 2 2 20 2 20 2 2 2 20 20 2 20 20 20 20 20 20 20 20 20 20 20 20
20 20 20 20 20 20 20 20 20 20 20 20 20 2 2 2 2 20 20 20 20 2 2 20 20 20 20 20 20 20 20 20 20 20 20 2 20 2 20 20 2 20 2 20 2 20 20 2 20 20 20 20 20 20 20 20 20 20 20 20
20 20 20 20 20 20 20 20 20 20 20 20 20 20 20 20 2 20 20 20 2 20 20 2 20 20 20 20 20 20 20 20 20 20 20 2 20 2 20 20 20 20 20 20 20 20 20 20 20 20 20 20 20 20 20 20 20 20 20 20
20 20 20 20 20 2 2 2 2 20 20 20 20 20 20 20 2 20 20 20 20 20 20 20 2 20 20 20 2 20 20 20 20 20 20 2 20 2 20 20 20 20 20 20 13 20 20 20 20 20 20 20 20 20 20 20 20 20 20 20
20 20 20 20 20 20 20 20 2 2 2 2 2 2 20 20 2 2 2 20 20 20 20 20 20 2 20 20 20 20 20 20 20 20 2 2 2 2 2 2 2 2 2 2 2 20 20 20 20 20 20 20 20 20 20 20 20 20 20 20
20 20 20 20 20 20 2 20 2 2 2 14 20 14 2 20 2 14 20 20 2 20 20 20 20 2 2 20 2 2 2 20 20 20 2 2 20 2 20 20 20 20 20 20 20 20 20 20 20 20 20 20 20 20 20 20 20 20 20 20
20 20 20 20 20 2 2 2 2 2 2 2 2 2 2 2 2 2 2 2 2 2 2 20 20 20 20 2 20 20 2 20 20 20 2 2 20 2 20 20 20 20 20 20 20 20 20 20 20 20 20 20 20 20 20 20 20 20 20 20
20 20 20 20 2 2 2 2 2 2 2 2 2 20 2 2 2 12 2 2 20 20 20 20 20 20 2 2 20 20 2 20 20 20 2 2 20 2 20 20 20 20 20 20 20 20 20 20 20 20 20 20 20 20 20 20 20 20 20 20
20 20 20 2 20 2 2 2 2 2 2 2 20 20 20 2 2 2 2 2 2 2 2 2 20 20 20 20 2 2 2 20 20 20 2 2 20 2 20 20 20 20 20 20 20 20 20 20 20 20 20 20 20 20 20 20 20 20 20 20
20 20 2 2 2 2 2 2 2 2 2 2 2 2 2 2 2 2 20 2 2 20 14 20 2 20 14 20 20 20 2 20 20 2 2 2 2 2 20 20 20 20 20 20 20 20 20 20 20 20 20 20 20 20 20 20 20 20 20 20
2 2 2 2 2 2 2 2 2 2 2 2 2 2 2 2 2 2 2 2 2 2 2 2 2 2 2 2 2 2 2 2 2 2 2 2 2 2 20 20 20 20 20 20 20 20 20 20 20 20 20 20 20 20 20 20 20 20 20 20
