20 20 20 20 20 20 20 20 20 20 20 20 20 20 20 20 20 20 20 20 20 20 20 20 20 20 20 20 20 20 20 20 20 20 20 20 20 20 20 20 20 20 20 20 20 20 20 20 20 20 20 20 20 20 20 20 20 20 20 2
20 20 20 20 20 20 20 20 20 20 20 20 20 20 20 20 20 20 20 20 20 20 20 20 20 20 20 20 20 20 20 20 20 20 20 20 20 20 20 20 20 20 20 20 20 20 20 20 20 20 20 20 20 20 20 20 20 20 20 2
20 20 20 20 20 20 20 20 20 20 20 20 20 20 20 20 20 20 20 20 20 20 20 20 20 20 20 20 20 20 20 20 20 20 20 20 20 20 20 20 20 20 20 20 20 20 20 20 20 20 20 20 20 20 20 20 20 20 20 2
20 20 20 20 20 20 20 20 20 20 20 20 20 20 20 20 20 20 20 20 20 20 20 20 20 20 20 20 20 20 20 20 20 20 20 20 20 20 20 20 20 20 20 20 20 20 20 20 20 20 20 20 20 20 20 2 20 20 20 2
20 20 20 20 20 20 20 20 20 20 20 20 20 20 20 20 20 20 20 20 20 20 20 20 20 20 20 20 20 20 20 20 20 20 20 20 20 20 20 20 20 20 20 20 20 14 20 20 20 20 20 20 20 20 2 20 20 20 20 2
20 20 20 20 20 2 20 20 20 20 20 20 20 20 20 20 20 20 20 20 20 20 20 20 20 20 20 20 14 20 20 20 20 20 20 20 20 20 20 20 20 20 20 20 20 2 2 20 20 20 20 20 20 2 20 20 20 20 20 20
20 20 20 20 20 20 20 20 14 20 20 20 20 20 20 20 20 20 20 20 2 20 20 20 20 20 20 20 2 2 20 20 20 20 20 20 20 20 20 20 20 20 20 20 20 20 20 20 20 20 20 20 2 20 20 20 20 20 20 20
20 20 2 2 20 20 20 20 2 2 2 2 2 2 20 20 20 20 20 20 20 20 20 20 20 20 20 20 20 20 20 20 20 2 2 20 20 20 20 20 20 20 20 20 20 20 20 20 20 20 20 2 20 20 20 2 2 2 2 2
20 20 20 20 20 20 20 2 20 20 20 20 20 20 2 20 20 20 2 20 20 20 20 20 2 2 2 2 2 2 2 20 20 20 20 20 20 20 20 2 2 2 2 2 2 2 2 2 2 2 2 20 20 20 20 20 20 20 20 2
20 20 20 20 2 2 2 20 20 20 20 20 20 20 20 2 20 20 20 20 20 20 20 2 20 20 20 20 20 20 20 2 20 20 20 20 20 20 2 20 20 20 20 20 20 20 20 20 20 20 20 20 20 20 20 20 20 20 20 2
20 20 20 2 20 20 20 20 20 20 20 20 20 20 20 20 2 20 20 20 20 20 2 20 20 20 20 20 20 20 20 20 2 20 20 20 20 2 20 20 20 20 20 20 20 20 20 20 20 20 20 20 20 20 20 20 20 20 20 2
0 2 2 2 20 20 20 20 20 20 20 20 20 20 20 20 20 2 2 2 2 2 2 20 20 20 20 20 20 20 20 20 20 2 2 2 2 2 20 20 20 20 20 20 20 20 20 20 20 20 20 20 20 20 20 20 20 20 20 20
